111111111111111111111111
1E000000C0000000000G0001
10100101001000C010010101
1010010010101010001001G1
1P0000000C00000000000001
111111111111111111111111