111111111111111111111111111111111111111111111111
1E0000000000000C000G0C01100000000000000C00000C01
101001010010000010100101101001010010000010100101
1010010010101010001001G11010010010101010001001G1
100000000C00C00000000001100000000C00C00000000001
100000000000000000000000000000000000000000000001
100000000000000000000000000000000000000000000001
100000000000000C00000C01100000000000000C000G0001
101001010010000010100101101001010010000010100101
101001001010101000100101101001001010101000100101
1P0000000C00C00000000000000000000C00C00000000001
111111111111111111111111111111111111111111111111