11111111111111111111111111111
10C0000000000000000G0C0100001
10100101001000001010010000001
1010010010101C10001001G000001
1P0000E00C00C0000000000001001
11111111111111111111111111111