111111111111111111111111111111111111111111111111111111111111
1E0000000000000C000G0C01100000000000000C00000C00000000000001
101001010010000010100101101001010010000010100100000000000C01
1010010010101010001001G1101001001010101000100100000000G00001
100000000C00C00000000001100000000C00C00000010000000000000C01
100000000000000G000000000000000000011000C11110000100C0000001
1000011100000000000000000000000000000000100000000000000G0001
100000000000000C00000C01100000000000000C000G000000C000000001
101001010010000010100101101001010010000010000100000100000001
10100100101010100010010110100100101010100000000C000000100101
1P0000000C00C00000000000000000000C00C00000000000000011000001
111111111111111111111111111111111111111111111111111111111111