111111111111111111111111111111111111111111111111111111111111
10C0000000000000000G0C0100000CC000C0000000000000000G1C010001
101001010010C0001010010000000100001001010010C000101000000001
1010010010010010001001G0000001000010010010101010001001G00001
100000E00011000000000000010000000000001000011000000000001001
100000C0000000010101010C00G00000000000C000000001010100C00G01
100001000C000000000000000G010100C0000010000C0000000000000G01
10C0000001111101000G0C0100000000000000000001111101000C010001
101000100100000100100100000000110000101010010000010001000001
101010010101110001000100000000010000101001010111001001000001
10000000C00C0000000000000100C010000000000C00C0000000000100C1
1100C0001000001010C00001000C01000G10000C00100000010C001000C1
100C000000111100000000C010001010010000C00000111000000C010001
10C0000000000000000G0C0010C010000000C00000000000000GC010C011
1010010100100110C01001C001100100000001000100001100101C110011
10100100101010100010C0100001G000000100100010101000C001000011
100000000000C010000C0100000000P00C00000000000C0000C010000001
10000000000C000000010C01000000000G00000000000C000010C0100001
10000100000000C010001000101000000010000100000001000100010101
10C00000000000011C0C01001111000C0100C00000000001C0C010011111
1010010100100000101C010000C0100000010000001000010C010000C011
1010010010101C100000C0100C0010001G0010000100C010000C0100C001
1C0000000C00C0000000000C01000000100C0000000C0000000000C01001
100000000000C010000C0100000000000C0000000000C010000C10000001
10000000000C000000010C0100000000G0000000000C0000000100100001
10000100000000C0100010001010000001000010000000C1000010010101
10C00000000000011C0C0100111100C010C0000000000011C0C001011111
1010010100100000101C010000C0100101000010010000101C010000C011
1010010010101C100000C0100C00100G001010001010C1000000C0100001
1C0000000C00C0000000000C010000100C0000000C0C00000000000C0101
111111111111111111111111111111111111111111111111111111111111